333333333333333333333
3m4488873878344483883
344444443499343443493
344444443433343433493
344433343434443438483
344434443434333434433
344434333444344434333
334334443434343334343
334333343434443874343
334444344434333444343
333334399934444433343
3344443aaa33333434443
333343333334444444333
377443444444333333333
399443333343344438883
344443887843343439993
333333999944443444413
333333333333333333333