33333333333333333333
37877888877887888773
39994999449444949993
34444006644660044443
34444886644668844443
32444444444444444443
31255555555555555553
32444444444444444443
34444776644667744443
34444006644660044443
34944994499944944993
38778887878877788783
33333333333333333333