33333333333333333333
37877888877887888773
39994999449444949993
34444336644663344443
34444876644667744443
3c444444444444444443
31255555555555555553
3c444444444444444443
34444ab664466aa44443
34444336644663344443
34944994499944944993
3abbbabbabaaabbaabb3
33333333333333333333